11111111111111111
1C0001C00010001C1
10000110001010E01
1P010000000010001
11111111111111111