111111111111111
100000P00000001
10000000000000001
111111111111111