111111111111111111111111111111111111111111111111111111111111111111111111111111111111111111111111111
100000000000000000000000000000000000000000000000000000000000000000000000000000000000000000000000001
100000000000000000000000000000000111001100000001000001100100100110000000000000000000000000000000001
100000000000000000000000000000001000010010000001000010010100101001000000000000000000000000000000001
100000000000000000000000000000000100010010000001000010010110101000000000000000000000000000000000001
100000000000000000000000000000000010010010000001000010010101101011000000000000000000000000000000001
100000000000000000000000000000000001010010000001000010010100101001000000000000000000000000000000001
100000000000000000000000000000001110001100111101111001100100100110000000000000000000000000000000001
100000000000000000000000000000000000000000000000000000000000000000000000000000000000000000000000001
100000000000000000000000000000000000000000000000000000000000000000000000000000000000000000000000001
100000000000000000000000000000000000000000000000000000000000000000000000000000000000000000000000001
100000000000000000000000000000000000000000000000000000000000000000000000000000000000000000000000001
100000000011001100000000000000000000000000000000000000000000000000000000000000000000110011000000001
100000000101010010000000000000000000000000000000000000000000000000000000000000000001010100100000001
100000001001000010000000000000000000000000000000000000000000000000000000000000000010010000100000001
100000001111000100000000000000000000000000000000000000000000000000000000000000000011110001000000001
100000000001001000000000000000000000000000000000000000000000000000000000000000000000010010000000001
100000000001010000000000000000000000000000000000000000000000000000000000000000000000010100000000001
100000000001011110000000000000000000000000000001110000000000000000000000000000000000010111100000001
100000000000000000000000000000000000000000011111E11111000000000000000000000000000000000000000000001
100000000000000000000000000000000000000000010000000001000000000000000000000000000000000000000000001
10000000000000000000000000000000000000000001C1C101C1C1000000000000000000000000000000000000000000001
100000000000000000000000000000000000000000011111011111000000000000000000000000000000000000000000001
1000000000000000000000000000000000000000000100C101C001000000000000000000000000000000000000000000001
100000000000000000000000000000000000000000010111011101000000000000000000000000000000000000000000001
100000000000000000000000000000000000000000010100P00101000000000000000000000000000000000000000000001
100000000000000000000000000000000000000000010001010001000000000000000000000000000000000000000000001
111111111111111111111111111111111111111111111111111111111111111111111111111111111111111111111111111