11111111111
10000E00001
1000C0C0001
10001110001
11111111111