11111111111
10000E00001
1000C0C0001
1P0011100P1
11111111111