1111111111111111111111111111111111111111111111111111111111111111111111111111111111111111111111111111
10010000000C000000000000000000000C000000000000000010000000C000000000000000000000C0000000000000000001
100001111100100000000000000000000C000000000000000110000000C000000000000000000000C0000000000000000001
100011E00000100000000000000000000C000000000000000110000000C000000000000000000000C0000000000000000001
100011E00000100000000000000000000C000000000000000110000000C000000000000000000000C0000000000000000001
100011E00000100000000000000000000C000000000000000110000000C000000000000000000000C0000000000000000001
100011E00000100000000000000000000C000000000000000110000000C000000000000000000000C0000000000000000001
100011E00000100000000000000000000C000000000000000110000000C000000000000000000000C0000000000000000001
100011E00000100000000000000000000C000000000000000110000000C000000000000000000000C0000000000000000001
100011E00000100000000000000000000C000000000000000110000000C000000000000000000000C0000000000000000001
100011E0000010000000000P0000000000C00000000000000110000000C000000000000000000000C0000000000000000001
100011E00000100000000000000000000C000000000000000110000000C000000000000000000000C0000000000000000001
100011E00000100000000000000000000C000000000000000110000000C000000000000000000000C0000000000000000001
100011E00000100000000000000000000C000000000000000110000000C000000000000000000000C0000000000000000001
100011E00000100000000000000000000C000000000000000110000000C000000000000000000000C0000000000000000001
100011E00000100000000000000000000C000000000000000110000000C000000000000000000000C0000000000000000001
100011E00000100000000000000000000C000000000000000110000000C000000000000000000000C0000000000000000001
100011E00000100000000000000000000C000000000000000110000000C000000000000000000000C0000000000000000001
100011E00000100000000000000000000C000000000000000110000000C000000000000000000000C0000000000000000001
100011E00000100000000000000000000C000000000000000110000000C000000000000000000000C0000000000000000001
100011E00000100000000000000000000C000000000000000110000000C000000000000000000000C0000000000000000001
100011E00000100000000000000000000C000000000000000110000000C000000000000000000000C0000000000000000001
100011E00000100000000000000000000C000000000000000110000000C000000000000000000000C0000000000000000001
100011E00000100000000000000000000C000000000000000110000000C000000000000000000000C0000000000000000001
100011E00000100000000000000000000C000000000000000110000000C000000000000000000000C0000000000000000001
100011E00000100000000000000000000C000000000000000110000000C000000000000000000000C0000000000000000001
100011E00000100000000000000000000C000000000000000110000000C000000000000000000000C0000000000000000001
100011E00000100000000000000000000C000000000000000110000000C000000000000000000000C0000000000000000001
100011E00000100000000000000000000C000000000000000110000000C000000000000000000000C0000000000000000001
100011E00000100000000000000000000C000000000000000110000000C000000000000000000000C0000000000000000001
100011E00000100000000000000000000C000000000000000110000000C000000000000000000000C0000000000000000001
100011E00000100000000000000000000C000000000000000110000000C000000000000000000000C0000000000000000001
100011E00000100000000000000000000C000000000000000110000000C000000000000000000000C0000000000000000001
100011E00000100000000000000000000C000000000000000110000000C000000000000000000000C0000000000000000001
100011E00000100000000000000000000C000000000000000110000000C000000000000000000000C0000000000000000001
100011E00000100000000000000000000C000000000000000110000000C000000000000000000000C0000000000000000001
100011E00000100000000000000000000C000000000000000110000000C000000000000000000000C0000000000000000001
100011E00000100000000000000000000C000000000000000110000000C000000000000000000000C0000000000000000001
100011E00000100000000000000000000C000000000000000110000000C000000000000000000000C0000000000000000001
100011E00000100000000000000000000C000000000000000110000000C000000000000000000000C0000000000000000001
1111111111111111111111111111111111111111111111111111111111111111111111111111111111111111111111111111