111111111111
110C100001E1
1001101101C1
100100010111
1PC001010001
111111111111